hello	xin chào
bye	tạm biệt
good	tốt
say	nói
old	cũ
new	mới
love	tinh yeu
hate	ghét
beautiful	xinh đẹp
build	xây dựng
said	nói
pay	trả
make	làm
face	mặt
run	chay
look	nhìn
alo	alo
die	chết
view	xem
for	cho
